umm: mtc
eci: pob
fam: oue kun
yxn: out
svr: xuq wew ntp
cew: thp hzm
qjs: nht tzn
hnx: gqa get
otr: bhg ojk aeo
nvg: ddb utf efb
vqw: xbc ntn
gsd: yws rfl
tnq: eci
adq: awf tvy hzm duj
zau: uxt dnm ppl yvp wcs
onk: jxw qvw
ejg: ylk zqx fen
viz: ypo voi
vzo: ska fbz igb
cdp: qhn qxh
mxu: nnp xna
noc: tmk aog
zfz: yvj nnp
wpg: nan amx
zrr: riu liv
gjq: pxj
avx: ays idp gsd
ygp: kcq iqg
pcd: rfl yws
qvj: dcx plv tek vwc
wew: gva wur jlw xmu hli tmd wgj jcu
psb: tzy itl bvp jat wbm
dgo: vlc rtf
mfp: rbn wtf
wih: sbu dja
xrk: ome ogu
nmv: ifu www qkf
dei: dja lzd
njo: xyr
hds: mfp qes jaz pbz zdl ycp nvg dew xpa gyo xdc tms rpo fpl
als: keg
mxv: nwz uyt
xhh: sgo xgr
wek: apm you tbq
opy: zqx fen dwy ylk
tqv: moq kjt aza zjd
lqu: rfl
qcn: bqc
yre: ndh hid ffv
oxq: gon zrn bux fxb
itu: iqy fty udy
uxl: xbc ntn
yzh: uat kuh ldi
gqa: cuc uac cqa gbq
kbu: tbq
igg: bur vwd
gdp: zjd kjt
ulq: tfy vsw mid epf
ceh: rfl fry
tms: bvp wbm jat itl tzy
arl: ntn
gyd: pdy hia
wso: qaa fft bns cmq
xoz: cqa
ggn: iqg
iqy: mup qaj ljm ruo
sxb: kkm mtc
cvu: zsg ooi
fhk: efb ddb
pdr: svq eyc wek bqc
hyu: tmk sxb
zor: zon
nnp: uvp cdp ahm klz
unt: cqa uac
fft: bux fxb zrn
nzq: ide
apm: eht snp esl rkk xnq jce sqf xhf agz
kvs: tmk aog umm sxb
vfx: idp gsd ays
lxj: qcn her egi pdr
ofi: ijy
ogu: out
erk: qbz
ofg: uac cqa
mlb: cqa uac
mzf: ylk dwy zqx
jaz: ddb lrn ksc
kuh: nki izx
iuv: dnm wcs
duj: zwa you
dap: llz noc
kwi: hem ehv dsw
fqi: htg pdy
vwb: yrt mfz
qxa: noc llz kvs hyu
doy: edr hid ndh
zdl: lrn ksc efb utf
zsr: qwa vcd
xbc: fcz nzf hyr vsv
ozt: pfl vpn slv egd
fsj: vwd bur hds
aya: aey hid ndh
baf: ucq dei lwz
hba: yws fry
wdm: tfy mid
xnq: uiq gof zwx oja
vgh: gbq uac cuc
roc: uyt
pxj: uyt nwz
rbn: ceh kqi opi yoz
ouf: swd cnp
edx: gyd fqi zgp bwa
dva: jjd
jcu: cjh fbz lzb
twq: mtb mlb
xle: onl xnn rfs
pbz: egd
zwa: jip sqf bzy hzz jqm snp yyb zjc
kun: kxb
iql: ntn
jbf: ftj tmv
hli: cjh ska fbz igb
qmv: hem dsw
qyg: tnq
gpw: sbu
tla: sbu dja
zld: cqa
eis: vwt uuf kjf vcd
gin: pdy htg
uxt: fav
zod: out
dsw: wiw qvw
vcn: wek
oyv: qbe
bwa: hia
zwr: kgr wdm
zbq: bkd
kgk: cuc uac
hzm: apm tbq zwa
yvp: hyi hnx
yqp: rfl fry yws
yft: mlb mtb
gyh: qkf zbp www ifu
yty: lhn fwm qcb
qes: mwm wtf
gnf: zon
unx: yzh eqc
swd: lzd dja
uac: qyg cdt fqw afc gbl ewc kut
mtb: uac cuc cqa
hwe: awf
fbz: exr sfb
bur: mqe nvg fhk jul qes rpo alh tan gyo xpa
orn: mup qaj ljm qns
vzk: tmv dac ftj
wig: zbx eis zsr
qns: poi rqf
kgr: kxb vsw epf
fty: qns ljm qaj mup
afc: ejg ukl mzf
vlc: out
bfc: bwa gyd
obg: cni dth xrk
tvy: tbq zwa
jjd: fry rfl
alh: tzy wbm bvp
rpo: rbn
ewc: xyr vzk jbf
you: yyb zjc gpr agz xtr
jhg: oqr xum jvu
poi: lwz dei ucq
bod: izx
epa: apm tbq zwa
ead: xbc yzc
xdc: klj
fop: zon
zjd: out
xva: you zwa apm
zjc: nzn doy
qaq: akr ggn ygp gep
ijy: mlb
htg: syj qjs yge yym wsg
onl: lzd
dxn: hid ndh ffv
sfd: als ppq
bqc: zwa tbq you apm
rwt: zwa you tbq
ifu: rqn ouf
obf: rfl
egd: avx yjn vfx
ljm: rqf
vwt: tla elq nvm tua
qtv: yea igg pez
vsv: zld
yym: nln nhu ney
fav: sgb unt gqa ofg get
uyu: bur
tzn: hds vwd
nan: out
wbm: tkk kmy viz
cqa: afc fqw ewc xrs cdt qhz gbl xvb kut pbl njo xey qyg fam iwh sfd cys lxj apt
yer: cxr wso
oev: yxj
izx: hds bur
zij: yzh xkf
udy: mup ljm qaj ruo
sny: uiq gof zwx gjq
rke: iuv ucg bmp zau
tzy: gyk kmy tkk viz
eve: yrr sta wld
igb: exr qoo bjq
dth: amw srp ogu
qbz: yws
yea: vwd
sgo: gbq cuc
kwn: cvu
tua: lzd
jqn: jvu xum oqr
dac: hcz blx bfh dso
ojk: out
gxm: bcf ctv qaq tpo
say: apm tbq zwa
sgb: gbq uac cuc
ooi: tqv mjw gdp
ide: rfs xnn
mup: rqf
plv: lzd
vwc: dja sbu
xvk: zbx eis zsr
cdt: qcn her pdr egi
yxj: zwa tbq apm
xfq: ifi jss xok
kqi: fry
edr: qvi frv bli obg olu
cmq: fxb
wxl: out
yja: xkf yzh eqc
ull: cvu zon qvm
yun: xgr
qfe: rao
bzy: lhn fwm
srp: out
yge: nln ney nht tzn
zmj: cqa uac
tpo: ggn ygp akr gep
eyc: you tbq
xey: mzf ukl ejg
rqn: swd cnp knd
zrn: hds bur
kkm: bur
zit: xok
rfs: lzd dja sbu
jul: wtf
qus: kom
lzb: sfb bjq
pez: vwd hds bur
iqg: nan lcw wxl
oqr: ide xle
keg: oev
evh: dcx
cfv: cut xhh qnf
qwa: tua nvm
bhg: out
ded: gbq cqa uac
jip: yre dxn doy aya
oue: tfy vsw mid
ezu: fqi gyd zgp
awf: zwa
rkk: kom juj
xok: njd erk asf
uvb: dnm wcs ppl yvp
hnh: iuv uvb zau
qqv: cut qnf yun
was: zsr eis zbx
rri: jjd odm
bux: vwd bur hds
dcx: dja
xrs: kun ulq
gof: tkr pxj mxv
ska: sfb
vwd: mfp mqe jaz ghe bpb psb dew ozt ycp xdc tms alh
yrr: urx qtv
coi: dja
feh: jss pxw ifi
kxb: nwd cew cdq
fcz: vgh zld jei
kqe: kbu pdz say
exg: zgp gyd gin bwa
oad: onl xnn
hcz: dbu rwt epa
jss: njd dva asf
blx: rwt epa
cnp: sbu lzd
jat: kmy tkk viz
hia: qjs wsg yge
lzf: yft ijy twq
uvp: vuu qhn qxh
urx: pez igg
iev: cxr wso
ifi: erk dva njd
lcw: out
tfy: cdq hwe nwd
sao: ctv nxy qaq
hzz: yre aya dxn
qxh: uac cuc gbq cqa
lwz: lzd
eol: qkf zbp
ney: vwd bur hds
ome: out
qbe: tek plv
moq: out
scf: pdz xva
riu: yxn ojk zod
bjq: qbe qvj
amw: out
hyi: sgb ofg gqa
fqw: xyr vzk
shc: kcq wpg
vuu: uac cqa
elq: dja
liv: bhg ojk zod
rfl: qqv cfv hje hnh arl rke lzf vqw ead mon zdi zqm bga vjy ccx iql zbq
bcf: shc gep akr ygp
xhv: swd knd
gyk: jju ypo obf
njb: yws
ahm: vuu qhn
ntp: xmu gyh eol vzo nmv tmd ujx jhg jlw fih itu xpi jcu
kut: ppq tnq ioz
fih: xvk wig
izo: vwd bur
aeo: out
lzd: dap bfc unx dnq exg eve ysp iev bix edx yja flw vwb hag yer rbr qxa ezu zze iez zij
sqf: ull
lrn: lqu
ldi: ncx nki
nwz: riu liv naw otr
her: wek
xmu: wig was xvk
tkr: nwz uyt zrr
iwh: opy ejg
hje: zfz
kmy: obf ypo voi
rqf: lwz wih
ppl: hyi
ukl: fen zqx ylk
mon: yun
ycp: swt xfq zit feh
qaa: gon zrn
thr: qtv
zgp: htg pdy hia
jju: yws
dja: dnq exg bfc dap ief ysp bix iev edx rbr vwb flw czu zze
yyb: juj gxm
gbl: ppq als ioz
bli: dth cni
bga: rji xhh cut
bfh: vdb
efb: fnb hba lqu pcd
dtz: jei xoz vgh kgk zld
cjh: exr sfb oyv qoo
epf: hwe adq cdq
voi: rfl yws fry
whm: dcx plv tek gpw
zze: xxh
aog: gor
hem: qvw nib
iez: wld thr
kfu: yvj nnp
ntn: vsv dtz nzf
njd: qbz jjd odm yqp
esl: gxm kom sao juj
vdb: tbq apm
cxr: fft qaa oxq cmq bns
svq: you tbq apm
mwm: yoz
zdi: kfu zfz
yvj: ahm vrl cdp
bix: hyu kvs llz
vcd: tla elq nvm coi
qvw: nrp zwz
cys: vzk
get: uac
ypo: rfl
tmd: zbp ifu qkf
oja: roc
qoo: qbe qvj evh
dnm: hnx fav
sta: qtv urx
sbu: iez ezu flw vwb czu hag rbr eve nsx bix ief bfc unx
utf: fnb
vrl: qxh vuu
nzn: hid aey
zqm: twq bkd yft
idp: rfl fry yws
mid: cdq adq cew
qhz: kun wdm ulq
uyt: naw liv
klz: qxh vuu
jqm: qcb fwm
xuq: jqn eol nmv itu jhg ujx wur
ndh: bli frv qvi olu
juj: qaq tpo
fxb: hds bur
qri: izo
ddb: lqu pcd gwj hba fnb
ftj: hcz dso
akr: wpg
bpb: tzy
syj: nht tzn nln
gwj: yws
bvp: viz gyk
jxw: nrp
aey: bli
wur: jvu nzq
slv: vfx yjn xrn
bns: gon fxb bux
gpr: zor fop gnf ull
pxw: rri asf erk njd dva
jvu: xle oad
thp: you tbq
kjt: out
fnb: fry
nln: vwd bur hds
amx: out
mfz: qri
ujx: www
jce: nzn
ppq: keg mwc
qvm: ooi hih zsg
jgm: out
vpn: avx xrn yjn
dnq: yrt qfe mfz
pob: dvt kde yxj
xpa: bvp jat
qhn: gbq
tek: sbu lzd
mam: pez igg
kom: ctv nxy qaq tpo
nrp: out
dbu: you
fen: sva scf
zbp: xhv
kjf: tua coi nvm elq tla
yzc: nzf vsv hyr
tan: kwb feh zit
ehv: nib dgo
zsg: gdp
ief: gyd gin
opi: rfl yws fry
yjn: ays gsd idp
pbl: tnq als
zwx: pxj tkr mxv
nxy: ggn ygp gep shc
xkf: bod kuh uat ldi
xum: xle ide
egi: eyc svq
frv: kvg xrk
llz: sxb umm aog
fpl: pfl
qvi: teu
tbq: xnq rkk gpr esl qus eht yyb agz sny xhf bzy jqm hzz xtr zjc jip sqf yty
swt: xok
mwc: cgn pob
zwz: out
dew: efb utf
xxh: bod kuh ldi
fcw: bns oxq
wld: urx qtv mam
wcs: hyi fav
gbq: lxj fam qyg cys sfd kut pbl zwr njo qhz fqw
iki: mjw
sfb: whm qbe evh
yws: ccx vjy bga zqm zdi zbq iql uxl ead mon rke ofi arl lzf qqv hnh hje cfv
nhu: hds bur
cdq: hzm duj
xnn: sbu dja lzd
uuf: elq
nwd: awf tvy
ksc: gwj
odm: rfl
xpi: udy orn
wiw: rtf
vjy: mxu kfu
hid: qvi bli obg frv olu
hag: yzh xxh
ysp: cxr
zqx: kqe
gep: wpg iqg
ctv: akr ggn shc
rtf: out
xyr: dac tmv ftj
naw: ojk yxn
qaj: baf rqf poi
uiq: roc tkr mxv
zon: iki zsg ooi hih
rao: izo uyu fsj
sva: say pdz
xgr: cqa uac cuc
rbr: zja
dso: rwt vdb dbu
nht: vwd
uat: ncx izx
asf: njb
nki: vwd
mqe: vpn egd slv
cgn: yxj dvt
rji: sgo zmj
kru: onk ehv
flw: noc llz kvs hyu
gva: fty
tmk: kkm
ffv: bli qvi olu
tkk: voi obf
hih: gdp
yrt: wfe qri
gon: hds
bmp: yvp ppl
cut: zmj xgr
mtc: vwd hds
ucq: sbu
knd: sbu
jlw: was
www: rqn xhv
vsw: adq cdq nwd
rlf: wfe
kde: zwa tbq you
qnf: sgo
ucg: dnm uxt
tmv: blx dso
olu: dth
mxn: ehv hem dsw
xrn: gsd
wfe: fsj
bkd: ded mlb
exr: qvj evh
pdy: syj qjs yge yym wsg
zbx: qwa vcd kjf uuf
ays: yws
ruo: rqf
mjw: zjd aza kjt
pfl: xrn vfx
jei: cuc uac
yoz: yws
zja: qtv
ylk: sva scf
xna: cdp vrl
cuc: fqw afc xrs qyg fam cys sfd iwh apt lxj gbl qhz pbl kut xvb zwr xey njo
czu: rlf qfe
xvb: vcn qcn
kvg: ogu jgm ome
qcb: kru mxn qmv
xtr: sao
ghe: kwb
dwy: sva
aza: out
gor: hds vwd
nvm: sbu
itl: viz
cni: ogu srp amw ome
ioz: mwc keg
snp: fop kwn
fry: hnh mon qqv iql vqw bga ofi vjy
nsx: fcw
eqc: bod uat
wgj: xvk was
wtf: opi kqi
kcq: lcw wxl amx
gyo: rbn mwm wtf
nib: zwz nrp rtf vlc
klj: xrn
hyr: zld vgh xoz jei
eht: uiq gof gjq
pdz: apm zwa you
ccx: uvb ucg zau bmp
nzf: kgk xoz jei
qkf: xhv
ncx: vwd bur hds
kwb: jss pxw ifi
lhn: mxn kwi kru qmv
wsg: nhu
fwm: kru mxn qmv
apt: ukl opy
teu: jgm ome ogu amw
agz: dxn aya yre
dvt: tbq apm
xhf: qcb
